ステージ,生成,,,,,,,,
2,3,3,3,3,3,3,3,3,2
3,7,3,3,3,3,3,3,7,3
3,3,3,3,3,3,3,3,3,3
3,3,3,3,3,3,5,3,3,3
3,3,3,3,3,3,3,3,3,3
3,3,3,3,3,3,3,3,3,3
3,3,3,5,3,3,5,3,3,3
3,3,3,3,3,3,3,3,3,3
3,7,3,3,3,3,3,3,3,3
2,3,3,3,3,3,3,3,3,1
