ステージ,生成,,,,,,,,,
3,3,3,3,3,3,3,3,4,3,
5,3,3,5,3,3,3,3,3,3,
3,3,3,3,3,6,3,3,3,3,
3,3,3,3,3,3,4,5,3,3,
3,3,3,3,3,3,3,3,3,3,
3,3,3,3,3,3,3,3,3,5,
3,4,3,3,3,3,3,3,3,3,
3,3,3,3,4,3,3,3,3,3,
3,3,6,3,3,3,3,3,3,3,2
3,3,3,3,3,3,5,3,3,1,2
